X,X,X,X,X,X,X,X
X,0,0,0,0,0,0,X
X,0,0,0,0,0,0,X
X,0,0,1,0,0,0,X
X,X,X,X,2,0,0,X
X,X,X,X,3,0,0,X
X,0,0,4,0,0,0,X
X,0,0,5,0,0,0,X
X,0,0,G,0,0,0,X
X,X,X,X,X,X,X,X
